RUS = "countries/russia.txt"
GAL = "countries/galicia.txt"
SLA = "countries/slavonia.txt"
CAU = "countries/cau.txt"
HSO = "countries/hso.txt"
ANT = "countries/ant.txt"
MXC = "countries/mxc.txt"
ITR = "countries/itr.txt"
TUN = "countries/tun.txt"
GOI = "countries/goi.txt"
GAF = "countries/gaf.txt"
GOC = "countries/goc.txt"
NPA = "countries/npa.txt"
RRU = "countries/rru.txt"
SIB = "countries/sib.txt"
ALS = "countries/als.txt"
TRK = "countries/trk.txt"
SUD = "countries/sud.txt"
FRR = "countries/frr.txt"
ALG = "countries/alg.txt"
MOR = "countries/mor.txt"
DSH = "countries/dsh.txt"
HEJ = "countries/hej.txt"
ITZ = "countries/ITZ.txt"
BAV = "countries/bav.txt"
KKR = "countries/kkr.txt"
KUR = "countries/kur.txt"
ALT = "countries/alt.txt"
PAM = "countries/pam.txt"
KAV = "countries/kav.txt"
FER = "countries/fer.txt"
UOB = "countries/uob.txt"
RHI = "countries/rhi.txt"
WRT = "countries/wrt.txt"
LAP = "countries/lap.txt"
TYR = "countries/tyr.txt"
ISP = "countries/isp.txt"
TRN = "countries/trn.txt"
KRD = "countries/krd.txt"
OTT = "countries/ott.txt"
SCH = "countries/sch.txt"
HAN = "countries/han.txt"
CYP = "countries/cyp.txt"
THR = "countries/thr.txt"
KAS = "countries/kas.txt"
KUB = "countries/kub.txt"
MAU = "countries/mau.txt"
CHC = "countries/chc.txt"
LAI = "countries/lai.txt"
KRS = "countries/krs.txt"
PRB = "countries/prb.txt"
BLT = "countries/blt.txt"
TLC = "countries/tlc.txt"
ARB = "countries/arb.txt"
TSI = "countries/tsi.txt"
NIN = "countries/nin.txt"
KAN = "countries/kan.txt"
SUI = "countries/sui.txt"
CHA = "countries/cha.txt"
SIC = "countries/sic.txt"
HEB = "countries/heb.txt"
GUI = "countries/gui.txt"
SHA = "countries/sha.txt"
HNE = "countries/hne.txt"
HBY = "countries/hby.txt"
ZHJ = "countries/zhj.txt"
JIA = "countries/jia.txt"
FUI = "countries/fui.txt"
JSU = "countries/jsu.txt"
ANH = "countries/anh.txt"
HNN = "countries/hnn.txt"
GTC = "countries/gtc.txt"